DecBG lvl1BG
Player 3 7.48438 64 64 2 2 10 18 3 1.3 5
Enemy 17.5741 3.06081 256 256 4 4 8 24 150 TallMushroom TallIdleSleep
Enemy 27.9421 2.27781 192 156 3 3 8 24 150 spinShroom spinIdle
Enemy 37.4191 3.03381 256 256 4 4 8 24 150 TallMushroom TallIdleSleep
Enemy 49.2181 2.25081 192 156 3 3 8 24 150 spinShroom spinIdle
Tile Dirt 0 1 2 2 0
Tile Dirt 1 1 2 2 0
Tile Dirt 2 1 2 2 0
Tile Dirt 3 1 2 2 0
Tile Dirt 4 1 2 2 0
Tile Dirt 5 1 2 2 0
Tile Dirt 6 1 2 2 0
Tile Dirt 7 1 2 2 0
Tile Dirt 8 1 2 2 0
Tile Dirt 9 1 2 2 0
Tile Dirt 10 1 2 2 0
Tile Dirt 11 1 2 2 0
Tile Dirt 12 1 2 2 0
Tile Dirt 13 1 2 2 0
Tile Dirt 14 1 2 2 0
Tile Dirt 15 1 2 2 0
Tile Dirt 16 1 2 2 0
Tile Dirt 17 1 2 2 0
Tile Dirt 18 1 2 2 0
Tile Dirt 19 1 2 2 0
Tile Dirt 20 1 2 2 0
Tile Dirt 21 1 2 2 0
Tile Dirt 22 1 2 2 0
Tile Dirt 23 1 2 2 0
Tile Dirt 24 1 2 2 0
Tile Dirt 25 1 2 2 0
Tile Dirt 26 1 2 2 0
Tile Dirt 27 1 2 2 0
Tile Dirt 28 1 2 2 0
Tile Dirt 29 1 2 2 0
Tile Rock 0 0 2 2 0
Tile Rock 1 0 2 2 0
Tile Rock 2 0 2 2 0
Tile Rock 3 0 2 2 0
Tile Rock 4 0 2 2 0
Tile Rock 5 0 2 2 0
Tile Rock 6 0 2 2 0
Tile Rock 7 0 2 2 0
Tile Rock 8 0 2 2 0
Tile Rock 9 0 2 2 0
Tile Rock 10 0 2 2 0
Tile Rock 11 0 2 2 0
Tile Rock 12 0 2 2 0
Tile Rock 13 0 2 2 0
Tile Rock 14 0 2 2 0
Tile Rock 15 0 2 2 0
Tile Rock 16 0 2 2 0
Tile Rock 17 0 2 2 0
Tile Rock 18 0 2 2 0
Tile Rock 19 0 2 2 0
Tile Rock 20 0 2 2 0
Tile Rock 21 0 2 2 0
Tile Rock 23 0 2 2 0
Tile Rock 24 0 2 2 0
Tile Rock 25 0 2 2 0
Tile Rock 26 0 2 2 0
Tile Rock 27 0 2 2 0
Tile Rock 28 0 2 2 0
Tile Rock 29 0 2 2 0
Tile Rock 22 0 2 2 0
Tile Dirt 30 1 2 2 0
Tile Dirt 31 1 2 2 0
Tile Dirt 32 1 2 2 0
Tile Dirt 33 1 2 2 0
Tile Dirt 34 1 2 2 0
Tile Dirt 35 1 2 2 0
Tile Dirt 36 1 2 2 0
Tile Dirt 37 1 2 2 0
Tile Dirt 38 1 2 2 0
Tile Dirt 39 1 2 2 0
Tile Dirt 40 1 2 2 0
Tile Dirt 41 1 2 2 0
Tile Dirt 42 1 2 2 0
Tile Dirt 43 1 2 2 0
Tile Dirt 44 1 2 2 0
Tile Dirt 45 1 2 2 0
Tile Dirt 46 1 2 2 0
Tile Dirt 47 1 2 2 0
Tile Dirt 48 1 2 2 0
Tile Dirt 49 1 2 2 0
Tile Dirt 50 1 2 2 0
Tile Dirt 51 1 2 2 0
Tile Dirt 52 1 2 2 0
Tile Dirt 53 1 2 2 0
Tile Rock 30 0 2 2 0
Tile Rock 31 0 2 2 0
Tile Rock 32 0 2 2 0
Tile Rock 33 0 2 2 0
Tile Rock 34 0 2 2 0
Tile Rock 35 0 2 2 0
Tile Rock 36 0 2 2 0
Tile Rock 37 0 2 2 0
Tile Rock 38 0 2 2 0
Tile Rock 39 0 2 2 0
Tile Rock 40 0 2 2 0
Tile Rock 41 0 2 2 0
Tile Rock 42 0 2 2 0
Tile Rock 43 0 2 2 0
Tile Rock 44 0 2 2 0
Tile Rock 45 0 2 2 0
Tile Rock 46 0 2 2 0
Tile Rock 47 0 2 2 0
Tile Rock 48 0 2 2 0
Tile Rock 49 0 2 2 0
Tile Rock 50 0 2 2 0
Tile Rock 51 0 2 2 0
Tile Rock 52 0 2 2 0
Tile Rock 53 0 2 2 0
Tile Dirt 54 1 2 2 0
Tile Dirt 55 1 2 2 0
Tile Dirt 56 1 2 2 0
Tile Dirt 57 1 2 2 0
Tile Dirt 58 1 2 2 0
Tile Dirt 59 1 2 2 0
Tile Dirt 60 1 2 2 0
Tile Dirt 61 1 2 2 0
Tile Dirt 62 1 2 2 0
Tile Dirt 63 1 2 2 0
Tile Dirt 64 1 2 2 0
Tile Dirt 65 1 2 2 0
Tile Dirt 66 1 2 2 0
Tile Dirt 67 1 2 2 0
Tile Dirt 68 1 2 2 0
Tile Dirt 69 1 2 2 0
Tile Dirt 70 1 2 2 0
Tile Dirt 71 1 2 2 0
Tile Dirt 72 1 2 2 0
Tile Dirt 73 1 2 2 0
Tile Dirt 74 1 2 2 0
Tile Dirt 75 1 2 2 0
Tile Dirt 76 1 2 2 0
Tile Dirt 77 1 2 2 0
Tile Dirt 78 1 2 2 0
Tile Dirt 79 1 2 2 0
Tile Dirt 80 1 2 2 0
Tile Dirt 81 1 2 2 0
Tile Dirt 82 1 2 2 0
Tile Rock 54 0 2 2 0
Tile Rock 55 0 2 2 0
Tile Rock 56 0 2 2 0
Tile Rock 58 0 2 2 0
Tile Rock 59 0 2 2 0
Tile Rock 60 0 2 2 0
Tile Rock 61 0 2 2 0
Tile Rock 63 0 2 2 0
Tile Rock 64 0 2 2 0
Tile Rock 65 0 2 2 0
Tile Rock 66 0 2 2 0
Tile Rock 67 0 2 2 0
Tile Rock 69 0 2 2 0
Tile Rock 70 0 2 2 0
Tile Rock 71 0 2 2 0
Tile Rock 72 0 2 2 0
Tile Rock 73 0 2 2 0
Tile Rock 74 0 2 2 0
Tile Rock 75 0 2 2 0
Tile Rock 76 0 2 2 0
Tile Rock 78 0 2 2 0
Tile Rock 79 0 2 2 0
Tile Rock 80 0 2 2 0
Tile Rock 81 0 2 2 0
Tile Rock 82 0 2 2 0
Tile Rock 77 0 2 2 0
Tile Rock 68 0 2 2 0
Tile Rock 62 0 2 2 0
Tile Rock 57 0 2 2 0